15 22 22 22 22 22 22 22 12 0 0 0 0 0 4 0 0 0 0 0 0 0 4
17 20 18 7 8 18 18 13 12 0 0 0 0 4 0 0 0 0 0 4 0 0 0
17 20 18 7 8 18 18 13 12 0 4 0 0 0 0 0 4 0 0 0 0 4 0
17 20 18 7 8 18 18 13 15 15 15 15 15 15 15 15 15 15 15 15 15 15 15
17 20 18 7 8 18 18 13 17 17 17 17 17 17 17 17 17 17 17 17 17 17 17
17 20 18 7 8 18 18 13 17 17 25 17 17 25 17 17 25 17 17 25 17 17 17
17 20 18 7 8 18 18 16 14 14 14 14 14 14 14 14 14 14 14 14 14 14 17
17 20 18 7 8 18 18 18 18 18 18 18 18 18 18 18 18 18 18 18 18 13 17
17 20 18 7 10 11 11 11 11 11 11 11 11 11 11 11 11 11 11 23 24 13 17
17 20 18 9 6 6 6 6 6 6 6 6 6 6 6 6 6 6 6 6 6 13 17
17 20 18 18 18 18 18 18 18 18 18 18 18 18 18 18 18 18 18 18 18 13 17
17 17 17 17 17 17 17 17 17 17 17 17 17 17 17 17 17 17 17 17 17 17 17