1 1 1 1 1 1 1 1 12 0 0 0 0 0 4 0
1 18 18 7 8 18 18 13 12 0 0 0 0 4 0 0
1 18 18 7 8 18 18 13 12 0 4 4 0 0 0 0
1 18 18 7 8 18 18 13 15 15 15 15 15 15 15 15
1 18 18 7 8 18 18 13 17 17 17 17 17 17 17 17
1 18 18 7 8 18 18 13 17 17 17 17 17 17 17 17
1 18 18 7 8 18 18 16 14 14 14 14 14 14 14 14
1 18 18 7 8 18 18 18 18 18 18 18 18 18 18 18
1 18 18 7 10 11 11 11 11 11 11 11 11 11 11 11
1 18 18 9 6 6 6 6 6 6 6 6 6 6 6 6
1 18 18 18 18 18 18 18 18 18 18 18 18 18 18 18
1 1 1 1 1 1 1 1 1 1 1 1 1 1 1 1